1111111111
1000000001
1111111101
1000000001
1011110111
1000000001
1111110101
1001000101
1000010001
1111111111

6/5

1/1
1/5
1/8
