1111111111111111111
1000000000000000001
1111111111111111101
1000000000000000001
1011110111111111101
1000000000000000101
1111110101111110101
1001000101111111101
1000010000000000001
1111111111111111111

1/1

15/6

1/5/t/1/5/15/5
1/8/f

