111111111111111111111111
101000100000000000000001
101000100000000000000001
101000100000000000000001
101000000001111111100001
101000100000000000000001
101000100000000000000001
101010100000000000000001
101111111111111111100001
101000000000000000100001
101000000000000000100001
101111111101111110100001
100000000000000000100001
101110111101111011100001
101000100100100000100001
101000000000100000100001
101000000000101111100001
101111111111100000000001
111111111111111111111111

1/1

3/1

2/12/t/2/12/17/12
17/7/t/7/7/22/7
22/1/t/22/1/7/1

