111111111111111111111111
100010100010100000000001
100000000010100000000001
100010100000000000000001
100010100010100000000001
111110111110111111111011
100000100000000010000001
101000100000000010000001
101111100001000011111011
100000000011100000000001
111101100001000011111011
100000100000000010000001
100000100000000010000001
111111111111111110000001
100000100010100000000001
100000100010000000000001
111011111010111111111111
100000000000000000000001
111111111111111111111111

2/4

1/14

21/4/f
15/12/t/15/6/15/12
1/17/t/1/17/16/17
7/6/t/7/6/7/11
