1111111111111111111
1000000000000000001
1011111111111111101
1010000000000000101
1010111111111110101
1010100000000010101
1010101101111110101
1010101001000010101
1010111011011110101
1010100000000000101
1010111111111111101
1010000000000000001
1011111111111111101
1000000000000000001
1111111111111111111

1/1

13/5

17/2/t/17/2/17/12
2/13/t/2/13/17/13
3/3/t/3/3/15/3
5/5/f
