1111111111111111111
1000010010100000001
1001011010101100101
1100100010100011001
1010001110101000101
1000100010100111001
1001101010101000011
1110000010100101001
1000101010110101101
1010010110100110001
1100100010101001011
1000001010100010001
1011111110111111101
1000000000000000001
1111111111111111111

9/1

13/10

1/13/t/1/13/17/13
4/9/f
5/3/f
17/1/f
13/4/f
