11111111111111111111111
10000000000000000000001
10111111111111111111101
10100000001000000000101
10110101101110101010101
10100101001010010010101
10100010010001110110101
10101111000100000010101
10110001111111111110101
10000100000000000000101
11111111111111111111101
10001000100010001000101
10101010101010101010101
10101010101010101010101
10100010001000100010001
11111111111111111111111

1/14

3/7

21/14/f
4/8/t/4/8/6/8
15/4/f
11/5/f
4/4/f
